20 20 13 10
1 1 1 1 1 1 1 1 1 1 1 1 1 1 1 1 1 1 1 1
1 4 4 4 4 4 4 4 4 4 4 4 4 4 4 4 4 4 4 1
1 4 4 6 4 4 4 4 4 4 4 4 4 4 4 4 4 4 4 1
1 4 4 4 4 4 4 4 4 4 4 4 4 4 4 5 6 4 4 1
1 4 4 8 4 4 4 4 4 4 6 4 4 4 4 6 4 4 4 1
1 4 4 4 4 4 6 4 4 4 4 4 4 4 4 0 4 4 4 1
1 4 4 4 4 4 4 4 4 4 4 4 4 4 4 4 4 4 4 1
1 4 5 4 4 4 5 4 4 4 4 4 6 4 5 4 4 4 4 1
1 4 4 4 4 5 4 4 4 4 4 4 4 4 4 4 4 4 4 1
1 4 4 4 4 0 4 4 4 4 4 4 4 4 5 4 4 4 4 1
1 6 4 4 4 0 4 4 6 4 4 4 4 4 4 4 4 4 4 1
1 4 4 4 4 4 4 4 4 4 4 4 4 4 4 4 4 4 4 1
1 4 0 4 4 4 3 3 3 4 4 4 4 4 4 4 4 4 4 1
1 4 4 4 4 3 4 4 4 4 4 4 4 4 4 4 4 4 4 1
1 4 4 4 4 4 4 4 4 4 4 4 6 4 5 4 4 4 4 1
1 4 4 6 4 4 4 4 4 4 4 4 4 4 4 4 4 4 4 1
1 4 4 6 4 4 4 4 4 4 4 4 4 4 4 4 4 4 4 1
1 4 5 0 4 4 4 4 4 3 3 3 3 4 4 0 4 6 6 1
1 4 4 4 4 4 4 4 4 4 4 4 4 4 4 4 4 4 7 1
1 1 1 1 1 1 1 1 1 1 1 1 1 1 1 1 1 1 1 1