22 40 18 12
1 1 1 1 1 1 1 1 1 1 1 1 1 1 1 1 1 1 1 1 1 1 1 1 1 1 1 1 1 1 1 1 1 1 1 1 1 1 1 1
1 4 4 4 4 4 4 0 4 4 6 4 5 0 4 4 4 4 4 5 4 5 4 4 4 4 4 4 4 0 4 4 4 4 5 4 4 4 4 1
1 4 5 8 5 4 4 4 4 4 4 0 4 4 4 4 4 4 4 4 4 5 6 4 4 5 4 4 4 4 0 4 4 4 4 4 0 4 4 1
1 4 4 4 4 4 4 4 4 4 4 0 4 4 5 4 4 4 4 4 5 4 5 4 4 5 4 4 4 4 4 4 4 4 5 4 4 4 4 1
1 5 4 5 5 4 4 4 4 4 4 4 4 4 5 4 4 4 4 4 4 5 4 4 5 4 4 4 4 5 4 4 4 5 4 4 4 4 4 1
1 5 4 0 5 4 4 4 4 4 4 4 4 4 4 5 4 4 5 4 4 4 4 4 4 4 4 5 4 4 4 4 4 4 5 4 5 5 4 1
1 4 4 4 0 4 4 5 4 4 4 4 4 4 4 4 5 4 4 4 4 4 5 4 0 5 4 4 4 4 4 4 4 4 5 4 5 5 4 1
1 3 3 3 3 3 3 3 3 3 3 3 3 3 3 3 3 3 3 3 3 3 3 3 3 3 3 3 3 3 3 4 4 4 5 4 4 5 4 1
1 4 0 4 4 4 5 4 4 6 4 0 4 4 5 4 5 4 4 4 4 4 4 4 4 4 4 6 4 5 6 4 4 4 4 4 4 0 4 1
1 4 4 6 4 4 4 4 4 5 4 4 4 4 4 0 4 4 4 4 4 4 4 4 5 5 0 5 4 4 5 4 4 4 4 5 4 4 4 1
1 4 4 4 5 4 4 5 4 5 4 4 4 4 4 4 4 4 4 4 4 4 4 4 5 0 4 5 4 4 5 4 4 4 4 4 4 4 4 1
1 4 5 4 4 4 4 4 5 4 4 4 4 4 4 4 4 5 5 5 4 4 4 4 4 4 4 5 4 4 0 4 6 4 4 4 4 5 4 1
1 4 6 4 4 0 4 4 5 4 0 0 4 4 4 4 4 5 4 5 6 4 4 6 4 4 4 4 5 4 4 4 5 4 4 6 4 0 4 1
1 4 0 5 4 4 4 4 4 4 4 4 4 4 4 4 4 4 5 0 5 4 4 5 4 4 4 4 4 4 4 4 6 4 4 4 4 4 5 1
1 4 4 4 4 4 4 4 4 3 3 3 3 3 3 3 3 3 3 3 3 3 3 3 3 3 3 3 3 3 3 3 3 3 3 3 3 3 3 1
1 0 5 4 4 4 4 4 4 4 4 4 5 4 4 4 6 4 4 4 4 5 4 4 4 4 4 5 4 4 4 5 4 4 4 4 4 4 4 1
1 0 5 4 4 4 4 4 4 4 4 4 0 5 4 4 5 4 4 4 4 4 4 4 4 5 4 4 4 4 4 4 5 4 5 5 4 4 7 1
1 4 0 4 4 5 4 4 4 4 4 4 4 4 5 4 4 4 4 4 5 4 0 0 4 4 4 4 6 4 4 4 5 4 5 5 4 4 4 1
1 4 4 4 4 5 6 4 4 5 4 4 4 4 4 4 4 4 5 4 4 4 4 4 4 5 4 5 6 4 4 4 4 4 4 5 4 4 4 1
1 4 4 4 0 4 4 5 4 0 4 4 5 4 5 5 4 4 4 4 4 4 4 4 4 5 4 5 6 4 4 4 4 4 4 0 4 4 5 1
1 4 6 4 4 4 4 0 4 4 4 4 4 0 4 4 4 4 4 4 4 4 4 0 4 5 4 4 5 4 4 4 4 5 4 4 4 5 4 1
1 1 1 1 1 1 1 1 1 1 1 1 1 1 1 1 1 1 1 1 1 1 1 1 1 1 1 1 1 1 1 1 1 1 1 1 1 1 1 1