15 20 10 7
1 1 1 1 1 1 1 1 1 1 1 1 1 1 1 1 1 1 1 1
1 7 4 4 4 4 4 4 4 8 4 4 4 4 4 4 4 4 4 1
1 4 4 4 0 5 5 5 6 4 4 4 0 4 4 4 4 4 4 1
1 3 3 3 3 3 3 0 4 6 4 4 4 4 4 0 4 4 4 1
1 3 4 4 6 4 4 4 4 4 4 4 4 4 4 4 4 5 3 1
1 0 0 0 4 5 5 5 4 4 3 3 4 4 4 4 4 4 4 1
1 4 5 4 6 4 4 4 4 4 4 3 4 4 0 4 4 4 4 1
1 4 4 4 6 4 4 4 4 4 4 4 4 4 4 4 4 4 4 1
1 4 4 4 4 4 4 4 4 4 4 4 4 4 4 4 4 4 4 1
1 4 4 4 4 4 4 4 4 4 4 3 4 4 4 4 4 4 4 1
1 3 3 3 3 4 4 4 4 4 4 4 4 4 3 3 3 3 3 1
1 6 6 5 4 4 4 4 4 0 0 0 4 4 4 4 4 5 4 1
1 4 4 4 4 4 4 4 4 4 4 4 4 5 5 5 4 4 6 1
1 4 4 4 4 5 4 4 5 4 4 4 4 4 4 4 4 6 6 1
1 1 1 1 1 1 1 1 1 1 1 1 1 1 1 1 1 1 1 1